##########################
#          #             #
# # ##     ### ##### ### #
#    ####          #     #
#          #   ## ##     #
### ##    #### #         #
#    #  #            #   #
#       ###    ## #### ###
#   #   #    #      #    #
#   #        #           #
##########################