##########################
# .........#.............#
###.##.....###.#####.###.#
#...####..........#......#
#..........#...## ##.....#
###.##....####.#.........#
#....#..#............#...#
#.......###....##.####.###
#...#...#....#......#....#
#...#........#...........#
##########################